{
    "citymap": {
        "layers": {
            "base": [
                [89,90,90,90,90,90,90,90,90,90,91,461,441,463,89,90,90,90,90,90,90,90,90,90,91],
                [116,117,117,117,117,117,117,117,117,117,118,461,441,463,27,28,28,28,28,28,29,28,28,28,34],
                [116,117,117,117,117,117,117,117,117,117,118,461,441,463,27,28,28,28,28,28,29,28,28,28,34],
                [116,117,117,117,117,117,117,117,117,117,118,461,441,463,27,28,28,28,28,28,29,28,28,28,34],
                [116,117,117,117,117,117,117,117,117,117,118,461,441,463,27,28,28,28,28,28,32,1,1,1,29],
                [116,117,117,117,117,117,117,117,117,117,118,461,441,463,27,28,28,28,28,28,28,28,28,28,29],
                [116,117,117,117,117,117,117,117,117,117,118,461,441,463,27,28,28,28,28,28,28,28,28,28,29],
                [116,117,117,117,117,117,117,117,117,117,118,461,441,463,27,28,28,28,28,28,28,28,28,28,29],
                [116,117,117,117,117,117,117,117,117,117,118,461,441,463,54,55,55,55,55,55,55,55,55,55,56],
                [116,117,117,117,117,117,117,117,117,117,118,461,441,463,89,90,90,90,90,90,90,90,90,90,91],
                [116,117,117,117,117,117,117,117,117,117,118,461,441,463,116,117,117,117,117,117,117,117,117,117,118],
                [116,117,117,117,117,117,117,117,117,117,118,461,441,463,116,117,117,117,117,117,117,117,117,117,118],
                [116,117,117,117,117,117,117,117,117,117,118,461,441,463,116,117,117,117,117,117,117,117,117,117,118],
                [116,117,117,117,117,117,117,117,117,117,118,461,441,463,116,117,117,117,117,117,117,117,117,117,118],
                [143,144,144,144,144,144,144,144,144,144,145,461,441,463,143,144,144,144,144,144,144,144,144,144,145],
                [406,406,406,406,406,406,406,406,406,406,406,467,441,466,406,406,406,406,406,406,406,406,406,406,406],
                [441,441,441,441,441,441,441,441,441,441,441,441,441,441,441,441,441,441,441,441,441,441,441,441,441],
                [460,460,460,460,460,460,460,460,460,460,460,440,441,439,460,460,460,460,460,460,460,460,460,460,460],
                [89,90,90,90,90,90,90,90,90,90,91,461,441,463,89,90,90,90,90,90,90,90,90,90,91],
                [116,117,117,117,117,117,117,117,117,117,118,461,441,463,116,117,117,117,117,117,117,117,117,117,118],
                [116,117,117,117,117,117,117,117,117,117,118,461,441,463,116,117,117,117,117,117,117,117,117,117,118],
                [116,117,117,117,117,117,117,117,117,117,118,461,441,463,116,117,117,117,117,117,117,117,117,117,118],
                [116,117,117,117,117,117,117,117,117,117,118,461,441,463,116,117,117,117,117,117,117,117,117,117,118],
                [143,144,144,144,144,144,144,144,144,144,145,461,441,463,143,144,144,144,144,144,144,144,144,144,145]
            ],
            "interact": [
                [486,486,486,486,486,486,486,486,486,486,486,486,486,486,486,486,486,486,486,486,486,486,486,486,486],
                [486,486,486,486,486,486,486,486,486,486,486,486,486,486,486,486,486,486,486,486,486,198,198,198,486],
                [486,486,486,486,486,486,486,486,486,486,486,486,486,486,486,486,486,486,486,486,486,198,198,198,486],
                [486,486,486,486,486,486,486,486,486,486,486,486,486,486,486,486,486,486,486,486,486,198,198,198,486],
                [486,486,486,486,486,486,486,486,486,486,486,486,486,486,486,486,486,486,486,486,486,486,486,486,486],
                [486,486,486,486,486,486,486,486,486,486,486,192,486,486,486,486,486,486,486,259,486,486,486,486,486],
                [486,486,486,486,486,486,486,486,486,486,486,486,486,486,486,486,486,486,486,486,486,486,486,486,486],
                [486,486,486,486,486,486,486,486,486,486,486,486,486,486,486,486,486,486,486,486,486,486,486,486,486],
                [486,486,486,486,486,486,486,486,486,486,486,486,486,486,486,486,486,486,486,486,486,486,486,486,486],
                [486,486,486,486,486,486,486,486,486,486,486,486,486,486,486,486,486,486,486,486,486,486,486,486,486],
                [486,486,486,486,486,486,486,486,486,486,486,486,486,486,486,486,486,486,486,486,486,486,486,486,486],
                [486,486,486,486,486,486,486,486,486,486,486,486,486,395,486,486,486,486,486,486,486,486,486,486,486],
                [486,486,486,486,486,486,486,486,486,486,486,192,486,422,486,486,486,486,486,486,486,486,486,486,486],
                [486,486,486,486,486,486,486,486,486,486,486,486,486,486,486,486,486,486,486,486,486,486,486,486,486],
                [486,486,486,486,486,486,486,486,486,486,486,486,486,486,486,486,486,486,486,486,486,486,486,486,486],
                [486,486,486,486,486,486,486,486,486,486,486,486,486,486,486,486,486,486,486,486,486,486,486,486,486],
                [486,486,486,486,486,486,486,486,486,486,486,486,486,486,486,486,486,486,486,486,486,486,486,486,486],
                [486,486,486,486,486,486,486,486,486,486,486,486,486,486,486,486,486,486,486,486,486,486,486,486,486],
                [486,486,486,486,486,486,486,486,486,486,486,486,486,486,486,486,486,486,486,486,486,486,486,486,486],
                [486,486,486,486,486,486,486,486,486,486,486,192,486,486,486,486,486,486,486,486,486,486,486,486,486],
                [486,486,486,486,486,486,486,486,486,486,486,486,486,486,486,486,486,486,486,486,486,486,486,486,486],
                [486,486,486,486,486,486,486,486,486,486,486,486,486,486,486,486,486,486,486,486,486,486,486,486,339],
                [486,486,486,486,486,486,486,486,486,486,486,486,486,486,486,486,486,486,486,486,486,486,486,486,486],
                [486,486,486,486,486,486,486,486,486,486,486,486,486,486,486,486,486,486,486,486,486,486,486,486,486],
                [486,486,486,486,486,486,486,486,486,486,486,486,486,486,486,486,486,486,486,486,486,486,486,486,486]
            ],
            "top": [
                [486,486,486,486,486,486,486,486,486,486,486,486,486,486,486,486,486,486,486,486,486,486,486,486,486],
                [486,486,486,486,486,486,486,486,486,486,486,486,486,486,486,486,486,486,486,486,486,486,486,486,486],
                [486,486,486,486,486,486,486,486,486,486,486,486,486,486,486,486,486,486,486,486,486,486,486,486,486],
                [486,486,486,486,486,486,486,486,486,486,486,486,486,486,486,486,486,486,486,486,486,486,486,486,486],
                [486,486,486,486,486,486,486,486,486,486,486,165,486,486,486,486,486,486,486,232,486,486,486,486,486],
                [486,486,486,486,486,486,486,486,486,486,486,486,486,486,486,486,486,486,486,486,486,486,486,486,486],
                [486,486,486,486,486,486,486,486,486,486,486,486,486,486,486,486,486,486,486,486,486,486,486,486,486],
                [486,486,486,486,486,486,486,486,486,486,486,486,486,486,486,486,486,486,486,486,486,486,486,486,486],
                [486,486,486,486,486,486,486,486,486,486,486,486,486,486,486,486,486,486,486,486,486,486,486,486,486],
                [486,486,486,486,486,486,486,486,486,486,486,486,486,486,486,486,486,486,486,486,486,486,486,486,486],
                [486,486,486,486,486,486,486,486,486,486,486,486,486,486,486,486,486,486,486,486,486,486,486,486,486],
                [486,486,486,486,486,486,486,486,486,486,486,165,486,486,486,486,486,486,486,486,486,486,486,486,486],
                [486,486,486,486,486,486,486,486,486,486,486,486,486,486,486,486,486,486,486,486,486,486,486,486,486],
                [486,486,486,486,486,486,486,486,486,486,486,486,486,486,486,486,486,486,486,486,486,486,486,486,486],
                [486,486,486,486,486,486,486,486,486,486,486,486,486,486,486,486,486,486,486,486,486,486,486,486,486],
                [486,486,486,486,486,486,486,486,486,486,486,486,486,486,486,486,486,486,486,486,486,486,486,486,486],
                [486,486,486,486,486,486,486,486,486,486,486,486,486,486,486,486,486,486,486,486,486,486,486,486,486],
                [486,486,486,486,486,486,486,486,486,486,486,486,486,486,486,486,486,486,486,486,486,486,486,486,486],
                [486,486,486,486,486,486,486,486,486,486,486,165,486,486,486,486,486,486,486,486,486,486,486,486,486],
                [486,486,486,486,486,486,486,486,486,486,486,486,486,486,486,486,486,486,486,486,486,486,486,486,486],
                [486,486,486,486,486,486,486,486,486,486,486,486,486,486,486,486,486,486,486,486,486,486,486,486,486],
                [486,486,486,486,486,486,486,486,486,486,486,486,486,486,486,486,486,486,486,486,486,486,486,486,486],
                [486,486,486,486,486,486,486,486,486,486,486,486,486,486,486,486,486,486,486,486,486,486,486,486,486],
                [486,486,486,486,486,486,486,486,486,486,486,486,486,486,486,486,486,486,486,486,486,486,486,486,486],
                [486,486,486,486,486,486,486,486,486,486,486,486,486,486,486,486,486,486,486,486,486,486,486,486,486]
            ]
        },
        "items": [
            {
                "variant": "healthPotion",
                "location": [10, 1]
            }
        ],
        "portals": [
            {
                "target": {
                    "map": "fieldmap",
                    "loc": [2, 2]
                },
                "loc": [25,22]
            }
        ],
        "npcs": [
            "Red", "Blue"
        ]
    },
    "fieldmap": {
        "layers": {
            "base": [
                [0,1,1,1,1,1,1,1,1,1,1,1,1,1,1,2],
                [27,28,28,28,28,28,28,28,28,28,28,28,28,28,28,29],
                [27,28,28,28,28,28,28,28,28,28,28,28,28,28,28,29],
                [27,28,28,28,28,28,28,28,28,28,28,28,28,28,28,29],
                [27,28,28,28,28,28,198,198,28,28,28,28,28,28,28,29],
                [27,28,28,28,28,28,198,198,28,28,28,28,28,28,28,29],
                [27,28,28,28,28,28,28,28,28,28,28,28,28,28,28,29],
                [27,28,28,28,28,28,28,28,28,28,28,28,28,28,28,29],
                [27,28,28,28,28,28,28,28,28,28,28,28,28,28,28,29],
                [27,28,28,28,28,28,28,28,28,28,28,28,28,28,28,29],
                [27,28,28,28,28,28,28,28,28,28,28,28,28,28,28,29],
                [27,28,28,28,28,28,28,28,28,28,28,28,28,28,28,29],
                [54,55,55,55,55,55,55,55,55,55,55,55,55,55,55,56]
            ],
            "interact": [
                [486,486,486,486,486,486,486,486,486,486,486,486,486,486,486,486],
                [486,339,486,486,486,486,486,486,486,486,486,486,486,486,486,486],
                [486,486,486,486,486,486,486,486,486,486,486,486,486,486,486,486],
                [486,486,486,486,486,170,171,171,172,486,486,486,486,486,486,486],
                [486,486,486,486,486,197,486,486,199,486,486,486,486,486,486,486],
                [486,486,486,486,486,197,486,486,199,486,486,486,486,486,486,486],
                [486,486,486,486,486,224,225,225,226,486,486,486,486,486,486,486],
                [486,486,486,486,486,486,486,486,486,486,486,486,486,486,486,486],
                [486,486,486,486,486,486,486,486,486,486,486,486,486,486,486,486],
                [486,486,486,486,486,486,486,486,486,486,486,486,486,486,486,486],
                [486,486,486,486,486,486,486,486,486,486,486,261,262,262,263,486],
                [486,486,486,486,486,486,486,486,486,486,486,288,289,289,290,486],
                [486,486,486,486,486,486,486,486,486,486,486,486,486,486,486,486]
            ],
            "top": [
                [486,486,486,486,486,486,486,486,486,486,486,486,486,486,486,486],
                [486,486,486,486,486,486,486,486,486,486,486,486,486,486,486,486],
                [486,486,486,486,486,486,486,486,486,486,486,486,486,486,486,486],
                [486,486,486,486,486,486,486,486,486,486,486,486,486,486,486,486],
                [486,486,486,486,486,486,486,486,486,486,486,486,486,486,486,486],
                [486,486,486,486,486,486,486,486,486,486,486,486,486,486,486,486],
                [486,486,486,486,486,486,486,486,486,486,486,486,486,486,486,486],
                [486,486,486,486,486,486,486,486,486,486,486,486,486,486,486,486],
                [486,486,486,486,486,486,486,486,486,486,486,486,486,486,486,486],
                [486,486,486,486,486,486,486,486,486,486,486,234,235,235,236,486],
                [486,486,486,486,486,486,486,486,486,486,486,486,486,486,486,486],
                [486,486,486,486,486,486,486,486,486,486,486,486,486,486,486,486],
                [486,486,486,486,486,486,486,486,486,486,486,486,486,486,486,486]
            ]
        },
        "items": [
            {
                "variant": "healthPotion",
                "location": [10, 3]
            }
        ],
        "portals": [
            {
                "target": {
                    "map": "citymap",
                    "loc": [25, 22]
                },
                "loc": [2,2]
            }
        ],
        "npcs": [
            "Yellow", "Dawn"
        ]
    },
    "jailmap": {
        "layers": {
            "base": [
                [486, 486, 486, 486, 486],
                [486,89, 90, 91, 486],
                [486, 116, 117, 118, 486],
                [486, 143, 144, 145, 486],
                [486, 486, 486, 486, 486]
            ],
            "interact": [
                [170, 171, 171, 171, 172],
                [197,339, 486, 339, 199],
                [197, 486, 486, 486, 199],
                [197, 486, 486, 486, 199],
                [224, 486, 486, 486, 226]
            ],
            "top": [
                [486, 486, 486, 486, 486],
                [486,486, 486, 486, 486],
                [486, 486, 486, 486, 486],
                [486, 486, 486, 486, 486],
                [486, 486, 486, 486, 486]
            ]
        },
        "items": [
            {
                "variant": "healthPotion",
                "location": [10, 3]
            }
        ],
        "portals": [
            {
                "target": {
                    "map": "citymap",
                    "loc": [13, 13]
                },
                "loc": [2,2]
            },
            {
                "target": {
                    "map": "fieldmap",
                    "loc": [13, 7]
                },
                "loc": [4,2]
            }
        ],
        "npcs": [
            "Cynthia"
        ]
    }
}