{
    "citymap": {
        "layers": {
            "base": [
                [ 89,  90,  90,  90,  90,  90,  90,  90,  90,  90,  91, 461, 441, 463,  27,  28,  28,  28,  28,  28,  29,  28,  28,  28],
                [ 116, 117, 117, 117, 117, 117, 117, 117, 117, 117, 118, 461, 441, 463,  27,  28,  28,  28,  28,  28,  29,  28,  28,  28],
                [ 116, 117, 117, 117, 117, 117, 117, 117, 117, 117, 118, 461, 441, 463,  27,  28,  28,  28,  28,  28,  29,  28,  28,  28],
                [ 116, 117, 117, 117, 117, 117, 117, 117, 117, 117, 118, 461, 441, 463,  27,  28,  28,  28,  28,  28,  29,  28,  28,  28],
                [ 116, 117, 117, 117, 117, 117, 117, 117, 117, 117, 118, 461, 441, 463,  27,  28,  28,  28,  28,  28,  32,   1,   1,   1],
                [ 116, 117, 117, 117, 117, 117, 117, 117, 117, 117, 118, 461, 441, 463,  27,  28,  28,  28,  28,  28,  28,  28,  28,  28],
                [ 116, 117, 117, 117, 117, 117, 117, 117, 117, 117, 118, 461, 441, 463,  27,  28,  28,  28,  28,  28,  28,  28,  28,  28],
                [ 116, 117, 117, 117, 117, 117, 117, 117, 117, 117, 118, 461, 441, 463,  27,  28,  28,  28,  28,  28,  28,  28,  28,  28],
                [ 116, 117, 117, 117, 117, 117, 117, 117, 117, 117, 118, 461, 441, 463,  54,  55,  55,  55,  55,  55,  55,  55,  55,  55],
                [ 116, 117, 117, 117, 117, 117, 117, 117, 117, 117, 118, 461, 441, 463,  89,  90,  90,  90,  90,  90,  90,  90,  90,  90],
                [ 116, 117, 117, 117, 117, 117, 117, 117, 117, 117, 118, 461, 441, 463, 116, 117, 117, 117, 117, 117, 117, 117, 117, 117],
                [ 116, 117, 117, 117, 117, 117, 117, 117, 117, 117, 118, 461, 441, 463, 116, 117, 117, 117, 117, 117, 117, 117, 117, 117],
                [ 116, 117, 117, 117, 117, 117, 117, 117, 117, 117, 118, 461, 441, 463, 116, 117, 117, 117, 117, 117, 117, 117, 117, 117],
                [ 116, 117, 117, 117, 117, 117, 117, 117, 117, 117, 118, 461, 441, 463, 116, 117, 117, 117, 117, 117, 117, 117, 117, 117],
                [ 143, 144, 144, 144, 144, 144, 144, 144, 144, 144, 145, 461, 441, 463, 143, 144, 144, 144, 144, 144, 144, 144, 144, 144],
                [ 406, 406, 406, 406, 406, 406, 406, 406, 406, 406, 406, 467, 441, 466, 406, 406, 406, 406, 406, 406, 406, 406, 406, 406],
                [ 441, 441, 441, 441, 441, 441, 441, 441, 441, 441, 441, 441, 441, 441, 441, 441, 441, 441, 441, 441, 441, 441, 441, 441],
                [ 460, 460, 460, 460, 460, 460, 460, 460, 460, 460, 460, 440, 441, 439, 460, 460, 460, 460, 460, 460, 460, 460, 460, 460],
                [  89,  90,  90,  90,  90,  90,  90,  90,  90,  90,  91, 461, 441, 463,  89,  90,  90,  90,  90,  90,  90,  90,  90,  90],
                [ 116, 117, 117, 117, 117, 117, 117, 117, 117, 117, 118, 461, 441, 463, 116, 117, 117, 117, 117, 117, 117, 117, 117, 117],
                [ 116, 117, 117, 117, 117, 117, 117, 117, 117, 117, 118, 461, 441, 463, 116, 117, 117, 117, 117, 117, 117, 117, 117, 117],
                [ 116, 117, 117, 117, 117, 117, 117, 117, 117, 117, 118, 461, 441, 463, 116, 117, 117, 117, 117, 117, 117, 117, 117, 117],
                [ 116, 117, 117, 117, 117, 117, 117, 117, 117, 117, 118, 461, 441, 463, 116, 117, 117, 117, 117, 117, 117, 117, 117, 117],
                [ 143, 144, 144, 144, 144, 144, 144, 144, 144, 144, 145, 461, 441, 463, 143, 144, 144, 144, 144, 144, 144, 144, 144, 144]
            ], "interact": [
                [  -1,  -1,  -1,  -1,  -1,  -1,  -1,  -1,  -1,  -1,  -1,  -1,  -1,  -1,  -1,  -1,  -1,  -1,  -1,  -1,  -1, 198, 198, 198],
                [  -1,  -1,  -1,  -1,  -1,  -1,  -1,  -1,  -1,  -1,  -1,  -1,  -1,  -1,  -1,  -1,  -1,  -1,  -1,  -1,  -1, 198, 198, 198],
                [  -1,  -1,  -1,  -1,  -1,  -1,  -1,  -1,  -1,  -1,  -1,  -1,  -1,  -1,  -1,  -1,  -1,  -1,  -1,  -1,  -1, 198, 198, 198],
                [  -1,  -1,  -1,  -1,  -1,  -1,  -1,  -1,  -1,  -1,  -1,  -1,  -1,  -1,  -1,  -1,  -1,  -1,  -1,  -1,  -1, 198, 198, 198],
                [  -1,  -1,  -1,  -1,  -1,  -1,  -1,  -1,  -1,  -1,  -1,  -1,  -1,  -1,  -1,  -1,  -1,  -1,  -1,  -1,  -1,  -1,  -1,  -1],
                [  -1,  -1,  -1,  -1,  -1,  413,  -1,  -1,  -1,  -1,  -1, 192,  -1,  -1,  -1,  -1,  -1,  -1,  -1, 259,  -1,  -1,  -1,  -1],
                [  -1,  -1,  -1,  -1,  -1,  -1,  -1,  -1,  -1,  -1,  -1,  -1,  -1,  -1,  -1,  -1,  -1,  -1,  -1,  -1,  -1,  -1,  -1,  -1],
                [  -1,  -1,  -1,  -1,  -1,  -1,  -1,  -1,  -1,  -1,  -1,  -1,  -1,  -1,  -1,  -1,  -1,  -1,  -1,  -1,  -1,  -1,  -1,  -1],
                [  -1,  -1,  -1,  -1,  -1,  -1,  -1,  -1,  -1,  -1,  -1,  -1,  -1,  -1,  -1,  -1,  -1,  -1,  -1,  -1,  -1,  -1,  -1,  -1],
                [  -1,  -1,  -1,  -1,  -1,  -1,  -1,  -1,  -1,  -1,  -1,  -1,  -1,  -1,  -1,  -1,  -1,  -1,  -1,  -1,  -1,  -1,  -1,  -1],
                [  -1,  -1,  -1,  -1,  -1,  -1,  -1,  -1,  -1,  -1,  -1,  -1,  -1,  -1,  -1,  -1,  -1,  -1,  -1,  -1,  -1,  -1,  -1,  -1],
                [  -1,  -1,  -1,  -1,  -1,  -1,  -1,  -1,  -1,  -1,  -1,  -1,  -1, 395,  -1,  -1,  -1,  -1,  -1,  -1,  -1,  -1,  -1,  -1],
                [  -1,  -1,  -1,  -1,  -1,  -1,  -1,  -1,  -1,  -1,  -1, 192,  -1, 422,  -1,  -1,  -1,  -1,  -1,  -1,  -1,  -1,  -1,  -1],
                [  -1,  -1,  -1,  -1,  -1,  -1,  -1,  -1,  -1,  -1,  -1,  -1,  -1,  -1,  -1,  -1,  -1,  -1,  -1,  -1,  -1,  -1,  -1,  -1],
                [  -1,  -1,  -1,  -1,  -1,  -1,  -1,  -1,  -1,  -1,  -1,  -1,  -1,  -1,  -1,  -1,  -1,  -1,  -1,  -1,  -1,  -1,  -1,  -1],
                [  -1,  -1,  -1,  -1,  -1,  -1,  -1,  -1,  -1,  -1,  -1,  -1,  -1,  -1,  -1,  -1,  -1,  -1,  -1,  -1,  -1,  -1,  -1,  -1],
                [  -1,  -1,  -1,  -1,  -1,  -1,  -1,  -1,  -1,  -1,  -1,  -1,  -1,  -1,  -1,  -1,  -1,  -1,  -1,  -1,  -1,  -1,  -1,  -1],
                [  -1,  -1,  -1,  -1,  -1,  -1,  -1,  -1,  -1,  -1,  -1,  -1,  -1,  -1,  -1,  -1,  -1,  -1,  -1,  -1,  -1,  -1,  -1,  -1],
                [  -1,  -1,  -1,  -1,  -1,  -1,  -1,  -1,  -1,  -1,  -1,  -1,  -1,  -1,  -1,  -1,  -1,  -1,  -1,  -1,  -1,  -1,  -1,  -1],
                [  -1,  -1,  -1,  -1,  -1,  -1,  -1,  -1,  -1,  -1,  -1, 192,  -1,  -1,  -1,  -1,  -1,  -1,  -1,  -1,  -1,  -1,  -1,  -1],
                [  -1,  -1,  -1,  -1,  -1,  -1,  -1,  -1,  -1,  -1,  -1,  -1,  -1,  -1,  -1,  -1,  -1,  -1,  -1,  -1,  -1,  -1,  -1,  -1],
                [  -1,  -1,  -1,  -1,  -1,  -1,  -1,  -1,  -1,  -1,  -1,  -1,  -1,  -1,  -1,  -1,  -1,  -1,  -1,  -1,  -1,  -1,  -1,  -1],
                [  -1,  -1,  -1,  -1,  -1,  -1,  -1,  -1,  -1,  -1,  -1,  -1,  -1,  -1,  -1,  -1,  -1,  -1,  -1,  -1,  -1,  -1,  -1,  -1],
                [  -1,  -1,  -1,  -1,  -1,  -1,  -1,  -1,  -1,  -1,  -1,  -1,  -1,  -1,  -1,  -1,  -1,  -1,  -1,  -1,  -1,  -1,  -1,  -1]
            ],"top": [
                [  -1,  -1,  -1,  -1,  -1,  -1,  -1,  -1,  -1,  -1,  -1,  -1,  -1,  -1,  -1,  -1,  -1,  -1,  -1,  -1,  -1,  -1,  -1,  -1],
                [  -1,  -1,  -1,  -1,  -1,  -1,  -1,  -1,  -1,  -1,  -1,  -1,  -1,  -1,  -1,  -1,  -1,  -1,  -1,  -1,  -1,  -1,  -1,  -1],
                [  -1,  -1,  -1,  -1,  -1,  -1,  -1,  -1,  -1,  -1,  -1,  -1,  -1,  -1,  -1,  -1,  -1,  -1,  -1,  -1,  -1,  -1,  -1,  -1],
                [  -1,  -1,  -1,  -1,  -1,  -1,  -1,  -1,  -1,  -1,  -1,  -1,  -1,  -1,  -1,  -1,  -1,  -1,  -1,  -1,  -1,  -1,  -1,  -1],
                [  -1,  -1,  -1,  -1,  -1,  -1,  -1,  -1,  -1,  -1,  -1, 165,  -1,  -1,  -1,  -1,  -1,  -1,  -1, 232,  -1,  -1,  -1,  -1],
                [  -1,  -1,  -1,  -1,  -1,  -1,  -1,  -1,  -1,  -1,  -1,  -1,  -1,  -1,  -1,  -1,  -1,  -1,  -1,  -1,  -1,  -1,  -1,  -1],
                [  -1,  -1,  -1,  -1,  -1,  -1,  -1,  -1,  -1,  -1,  -1,  -1,  -1,  -1,  -1,  -1,  -1,  -1,  -1,  -1,  -1,  -1,  -1,  -1],
                [  -1,  -1,  -1,  -1,  -1,  -1,  -1,  -1,  -1,  -1,  -1,  -1,  -1,  -1,  -1,  -1,  -1,  -1,  -1,  -1,  -1,  -1,  -1,  -1],
                [  -1,  -1,  -1,  -1,  -1,  -1,  -1,  -1,  -1,  -1,  -1,  -1,  -1,  -1,  -1,  -1,  -1,  -1,  -1,  -1,  -1,  -1,  -1,  -1],
                [  -1,  -1,  -1,  -1,  -1,  -1,  -1,  -1,  -1,  -1,  -1,  -1,  -1,  -1,  -1,  -1,  -1,  -1,  -1,  -1,  -1,  -1,  -1,  -1],
                [  -1,  -1,  -1,  -1,  -1,  -1,  -1,  -1,  -1,  -1,  -1,  -1,  -1,  -1,  -1,  -1,  -1,  -1,  -1,  -1,  -1,  -1,  -1,  -1],
                [  -1,  -1,  -1,  -1,  -1,  -1,  -1,  -1,  -1,  -1,  -1, 165,  -1,  -1,  -1,  -1,  -1,  -1,  -1,  -1,  -1,  -1,  -1,  -1],
                [  -1,  -1,  -1,  -1,  -1,  -1,  -1,  -1,  -1,  -1,  -1,  -1,  -1,  -1,  -1,  -1,  -1,  -1,  -1,  -1,  -1,  -1,  -1,  -1],
                [  -1,  -1,  -1,  -1,  -1,  -1,  -1,  -1,  -1,  -1,  -1,  -1,  -1,  -1,  -1,  -1,  -1,  -1,  -1,  -1,  -1,  -1,  -1,  -1],
                [  -1,  -1,  -1,  -1,  -1,  -1,  -1,  -1,  -1,  -1,  -1,  -1,  -1,  -1,  -1,  -1,  -1,  -1,  -1,  -1,  -1,  -1,  -1,  -1],
                [  -1,  -1,  -1,  -1,  -1,  -1,  -1,  -1,  -1,  -1,  -1,  -1,  -1,  -1,  -1,  -1,  -1,  -1,  -1,  -1,  -1,  -1,  -1,  -1],
                [  -1,  -1,  -1,  -1,  -1,  -1,  -1,  -1,  -1,  -1,  -1,  -1,  -1,  -1,  -1,  -1,  -1,  -1,  -1,  -1,  -1,  -1,  -1,  -1],
                [  -1,  -1,  -1,  -1,  -1,  -1,  -1,  -1,  -1,  -1,  -1,  -1,  -1,  -1,  -1,  -1,  -1,  -1,  -1,  -1,  -1,  -1,  -1,  -1],
                [  -1,  -1,  -1,  -1,  -1,  -1,  -1,  -1,  -1,  -1,  -1, 165,  -1,  -1,  -1,  -1,  -1,  -1,  -1,  -1,  -1,  -1,  -1,  -1],
                [  -1,  -1,  -1,  -1,  -1,  -1,  -1,  -1,  -1,  -1,  -1,  -1,  -1,  -1,  -1,  -1,  -1,  -1,  -1,  -1,  -1,  -1,  -1,  -1],
                [  -1,  -1,  -1,  -1,  -1,  -1,  -1,  -1,  -1,  -1,  -1,  -1,  -1,  -1,  -1,  -1,  -1,  -1,  -1,  -1,  -1,  -1,  -1,  -1],
                [  -1,  -1,  -1,  -1,  -1,  -1,  -1,  -1,  -1,  -1,  -1,  -1,  -1,  -1,  -1,  -1,  -1,  -1,  -1,  -1,  -1,  -1,  -1,  -1],
                [  -1,  -1,  -1,  -1,  -1,  -1,  -1,  -1,  -1,  -1,  -1,  -1,  -1,  -1,  -1,  -1,  -1,  -1,  -1,  -1,  -1,  -1,  -1,  -1],
                [  -1,  -1,  -1,  -1,  -1,  -1,  -1,  -1,  -1,  -1,  -1,  -1,  -1,  -1,  -1,  -1,  -1,  -1,  -1,  -1,  -1,  -1,  -1,  -1]
            ]
        },
        "items": [
            {
                "variant": "PotionHealth",
                "location": [  10,   1]
            }
        ],
        "portals": [
            {
                "target": {
                    "map": "fieldmap",
                    "loc": [   2,   2]
                },
                "loc": [  5,  5]
            }
        ],
        "npcs": [
            "Cynthia", "Red", "Blue", "Yellow", "Dawn"
        ]
    },
    "fieldmap": {
        "layers": {
            "base": [
                [   0,   1,   1,   1,   1,   1,   1,   1,   1,   1,   1,   1,   1,   1,   1,   2],
                [  27,  28,  28,  28,  28,  28,  28,  28,  28,  28,  28,  28,  28,  28,  28,  29],
                [  27,  28,  28,  28,  28,  28,  28,  28,  28,  28,  28,  28,  28,  28,  28,  29],
                [  27,  28,  28,  28,  28,  28,  28,  28,  28,  28,  28,  28,  28,  28,  28,  29],
                [  27,  28,  28,  28,  28,  28, 198, 198,  28,  28,  28,  28,  28,  28,  28,  29],
                [  27,  28,  28,  28,  28,  28, 198, 198,  28,  28,  28,  28,  28,  28,  28,  29],
                [  27,  28,  28,  28,  28,  28,  28,  28,  28,  28,  28,  28,  28,  28,  28,  29],
                [  27,  28,  28,  28,  28,  28,  28,  28,  28,  28,  28,  28,  28,  28,  28,  29],
                [  27,  28,  28,  28,  28,  28,  28,  28,  28,  28,  28,  28,  28,  28,  28,  29],
                [  27,  28,  28,  28,  28,  28,  28,  28,  28,  28,  28,  28,  28,  28,  28,  29],
                [  27,  28,  28,  28,  28,  28,  28,  28,  28,  28,  28,  28,  28,  28,  28,  29],
                [  27,  28,  28,  28,  28,  28,  28,  28,  28,  28,  28,  28,  28,  28,  28,  29],
                [  54,  55,  55,  55,  55,  55,  55,  55,  55,  55,  55,  55,  55,  55,  55,  56]
            ],
            "interact": [
                [  -1,  -1,  -1,  -1,  -1,  -1,  -1,  -1,  -1,  -1,  -1,  -1,  -1,  -1,  -1,  -1],
                [  -1, -1,  -1,  -1,  -1,  -1,  -1,  -1,  -1,  -1,  -1,  -1,  -1,  -1,  -1,  -1],
                [  -1,  -1,  339,  -1,  -1,  -1,  -1,  -1,  -1,  -1,  -1,  -1,  -1,  -1,  -1,  -1],
                [  -1,  -1,  -1,  -1,  -1, 170, 171, 171, 172,  -1,  -1,  -1,  -1,  -1,  -1,  -1],
                [  -1,  -1,  -1,  -1,  -1, 197,  -1,  -1, 199,  -1,  -1,  -1,  -1,  -1,  -1,  -1],
                [  -1,  -1,  -1,  -1,  -1, 197,  -1,  -1, 199,  -1,  -1,  -1,  -1,  -1,  -1,  -1],
                [  -1,  -1,  -1,  -1,  -1, 224, 225, 225, 226,  -1,  -1,  -1,  -1,  -1,  -1,  -1],
                [  -1,  -1,  -1,  -1,  -1,  -1,  -1,  -1,  -1,  -1,  -1,  -1,  -1,  -1,  -1,  -1],
                [  -1,  -1,  -1,  -1,  -1,  -1,  -1,  -1,  -1,  -1,  -1,  -1,  -1,  -1,  -1,  -1],
                [  -1,  -1,  -1,  -1,  -1,  -1,  -1,  -1,  -1,  -1,  -1,  -1,  -1,  -1,  -1,  -1],
                [  -1,  -1,  -1,  -1,  -1,  -1,  -1,  -1,  -1,  -1,  -1, 261, 262, 262, 263,  -1],
                [  -1,  -1,  -1,  -1,  -1,  -1,  -1,  -1,  -1,  -1,  -1, 288, 289, 289, 290,  -1],
                [  -1,  -1,  -1,  -1,  -1,  -1,  -1,  -1,  -1,  -1,  -1,  -1,  -1,  -1,  -1,  -1]
            ],
            "top": [
                [  -1,  -1,  -1,  -1,  -1,  -1,  -1,  -1,  -1,  -1,  -1,  -1,  -1,  -1,  -1,  -1],
                [  -1,  -1,  -1,  -1,  -1,  -1,  -1,  -1,  -1,  -1,  -1,  -1,  -1,  -1,  -1,  -1],
                [  -1,  -1,  -1,  -1,  -1,  -1,  -1,  -1,  -1,  -1,  -1,  -1,  -1,  -1,  -1,  -1],
                [  -1,  -1,  -1,  -1,  -1,  -1,  -1,  -1,  -1,  -1,  -1,  -1,  -1,  -1,  -1,  -1],
                [  -1,  -1,  -1,  -1,  -1,  -1,  -1,  -1,  -1,  -1,  -1,  -1,  -1,  -1,  -1,  -1],
                [  -1,  -1,  -1,  -1,  -1,  -1,  -1,  -1,  -1,  -1,  -1,  -1,  -1,  -1,  -1,  -1],
                [  -1,  -1,  -1,  -1,  -1,  -1,  -1,  -1,  -1,  -1,  -1,  -1,  -1,  -1,  -1,  -1],
                [  -1,  -1,  -1,  -1,  -1,  -1,  -1,  -1,  -1,  -1,  -1,  -1,  -1,  -1,  -1,  -1],
                [  -1,  -1,  -1,  -1,  -1,  -1,  -1,  -1,  -1,  -1,  -1,  -1,  -1,  -1,  -1,  -1],
                [  -1,  -1,  -1,  -1,  -1,  -1,  -1,  -1,  -1,  -1,  -1, 234, 235, 235, 236,  -1],
                [  -1,  -1,  -1,  -1,  -1,  -1,  -1,  -1,  -1,  -1,  -1,  -1,  -1,  -1,  -1,  -1],
                [  -1,  -1,  -1,  -1,  -1,  -1,  -1,  -1,  -1,  -1,  -1,  -1,  -1,  -1,  -1,  -1],
                [  -1,  -1,  -1,  -1,  -1,  -1,  -1,  -1,  -1,  -1,  -1,  -1,  -1,  -1,  -1,  -1]
            ]
        },
        "items": [
            {
                "variant": "PotionHealth",
                "location": [  10,   3]
            }
        ],
        "portals": [
            {
                "target": {
                    "map": "citymap",
                    "loc": [  25,  22]
                },
                "loc": [   2,   2]
            }
        ],
        "npcs": [
            "Yellow", "Dawn"
        ]
    },
    "jailmap": {
        "layers": {
            "base": [
                [  -1,  -1,  -1,  -1,  -1],
                [  -1,  89,  90,  91,  -1],
                [  -1, 116, 117, 118,  -1],
                [  -1, 143, 144, 145,  -1],
                [  -1,  -1,  -1,  -1,  -1]
            ],
            "interact": [
                [ 170, 171, 171, 171, 172],
                [ 197, 282,  -1, 283, 199],
                [ 197,  -1,  -1,  -1, 199],
                [ 197,  -1,  -1,  -1, 199],
                [ 224,  -1,  -1,  -1, 226]
            ],
            "top": [
                [  -1,  -1,  -1,  -1,  -1],
                [  -1,  -1,  -1,  -1,  -1],
                [  -1,  -1,  -1,  -1,  -1],
                [  -1,  -1,  -1,  -1,  -1],
                [  -1,  -1,  -1,  -1,  -1]
            ]
        },
        "items": [
            {
                "variant": "PotionHealth",
                "location": [  10,   3]
            }
        ],
        "portals": [
            {
                "target": {
                    "map": "citymap",
                    "loc": [  13,  13]
                },
                "loc": [   1,   1]
            },
            {
                "target": {
                    "map": "fieldmap",
                    "loc": [  13,   7]
                },
                "loc": [   1,   3]
            }
        ],
        "npcs": [
            "Red", "Blue"
        ]
    }
}
